-32
30
-25
26
00000000000000000000000000000000000000000000000000000000000000
11111111111111111111100011111111111111111111111111111111111111
11111111111111111111100011111111111111111111111111111111111111
11111111111111111111100011111111111111111111111111111111111111
11111111100000000000000011111111111111111111111111111111111111
00000000000000000000000011111111111111111111111111111111111111
00000000000000000000000011111111111111111111111111111111111111
00000000000000000000000011111111111111111111111111111111111111
11110000000000010000000000011111111111111111111111111111111111
11110000000000000000000000011111111111111111111111111111111111
11110000000000000000000000011111111111111111111111111111111111
11110000000000000000000000000111111111111111111111111111111111
11110000000000000000000000000111111111111111111111111111111111
11110000001000000000000000000111111111111111111100000011111111
11111100000000000000000000000000000001111111111000000000001111
11111100000000000010000000000000000000011111111000000000000111
11111100000000000000000000000000000000011111111000000000000011
11111111000000000000000000000010000000011111111000000000000001
11111111000000000000000000000000000000011111111000001010000001
11111111000000000000000111111000001110011111111000000110000001
11111111110000000000001111111100001110000011111110000000000001
11111111110000010000011111111100000000000011111110000000001000
11111111110000000000001111111100000000000011111110000000000000
10001111110000000000001111111100000000000000111110000100000000
10000111111100000000001111111111000000010000111110000000000000
10100111111100000000001111111100000000000000111110000000000000
10000111111100000000001111111100000000000000111110000001110000
10000011111100000001000111111000000001010000111110000001110000
10000011111100000000000000000000000001010000111100000001110001
10001011111100000000000000000000000000000011111100000001110001
10010001111100000000000000000000000000000011111100000000000001
10000001111100000000000000011000000000000011111100000000110001
10111001111111111111111100011000000000000011111100111000000001
10111011111111111111111100000000000000000011111100111000000001
10111011111111111111111111111100000000000011111100000000000001
10001111111111111111111111111100000000000011111000000000000001
10011111111111111111111111111100001000000011110000000000000001
11111111111110000000000111111100000000000011110000000000000011
11111111111100000000000001111100000000000111110000000000000111
11111111000000000000000000111100000000000111110000100000000111
11111110000000000100001000111100000000000111110000101000001111
11111110001100000000001000011100000000000111110000000000001111
11111110001100000000000000011100000011111111110000000000001111
11111110000000000000100000011100000011111111110000000000011111
11111111000000000000000000111100011111111111110000000000111111
11111111111100000000000001111111111111111111111111111111111111
11111111111110000000000011111111111111111111111111111111111111
11111111111111110000000111111111111111111111111111111111111111
11111111111111111111111111111111111111111111111111111111111111
00000000000000000000000000000000000000000000000000000000000000
00000000000000000000000000000000000000000000000000000000000000
