-31
30
-23
25
1111111111111111111111111111000111111111111111111111111111111
1111000000000000011111111111000111111111111111111111111111111
1111011010000000011111111111000111111111111111111111111111111
1111011010000000011111111111000111111111111111111111111111111
1111000000000000000000000000000111111110100000000000000000000
1111001111100011000000000000000111111110000000000000000000000
1111001110100000000000000000000111111110000000000000000000000
1111001111110000001111111111000111111110001111111111111111111
0000000000000000001111111111000111111110001111111111111111111
0011000000000000001111111111000111111110001111111111111111111
0011000000000000001111111111000111111110001111111111111111111
0011000100000000001111111111001111111110001111111111111111111
0000000000000000001111111111000111111110001111111111111111111
1111111111111111111111111111000111111110011111111111111111111
1111111111111111111111111111000111111110001111111111101111111
1111111111111111111111111111000111111110001111111110000011111
1111111111111111111111111111000111111110001111111110000011111
1111111111111111111111111111100111111110001111111110000011111
1100000000000000000000111111000111111110001111111110000011111
1100000000000000000010111111000000000000001111111110000011111
1100011110011111011100111111000000000000001111111110000011111
1100011110011111011100111111000000000100001111111111000111111
1100111110111111000000111111000111111111111111111111000111111
1100000000000000000000111111000111111111111111111111000111111
1100000000000000000000100000000111111111111111001000000111111
1100000000000000000000000000001111111111111111000000000111111
1100001000000000000000000000000111111111111111000000000111111
1100000000010000000000000001000111111111111111000111111111111
1100000000000000000011100001000111111111111111000111111111111
1100000000000000000011100001000111111111111111000111111111111
1100000000000000000000000001000111111111111111100111111111111
1101111111100000000000010001100000001000000000000111111111111
1101100001100000000000000001000000000000000000000111111111111
1101111111100001111110000001000000000000000000000000100000011
1101111111100011111110000001000011100011100011111000000000011
1101110011100000000000000001000011100011100011111000111000011
1100000001000000000000000001000011100011100011111000111000011
1100000000000000000000000001000000000000000000000000111000011
1100000000000000000000000001100000000000000000000000000000111
1111111111111111111111111111000000000000000000000000000000011
1111111111111111111111111111000011111001111100001111000000011
1111111111111111111111111111000011111001101100001111000000011
1111111111111111111111111111000011111001111100001111000000011
1111111111111111111111111111000000000000000000000000000000011
1111111111111111111111111111000000000100000000010000000000011
1111111111111111111111111111111111111111111111111111111111111
1111111111111111111111111111111111111111111111111111111111111
1111111111111111111111111111111111111111111111111111111111111
