-20
19
-17
16
110001111111111111111111111111111111111
110001111111111111111111111111111111111
110001111111101000000000000011111111111
110001111111101011110000011111111111111
110001111111100111110000011111111111111
110000000000000000000000011111111111111
110001111111100000000000011111111111111
110001111111111111111111111111111111111
110001111111111111111111111111111111111
110001111111111111111111111111111000000
110001111111111111111111111111111000000
110001111111111111111111111111111000000
110001111111111111111111111111111000111
110001111111111111111111111111111000111
110001111111111111111111111111100000111
110000000000000000000000000000000000111
110000000001111111111111111111100001111
110001111111111111111111111111111111111
110001111111111111111111111111111111111
110001111111111111111111111111111111111
110001111111111111111111111111111111111
110001111111000111111111111111111111111
110001111111000111111111111111111111111
110000000000000000000000000000000000111
110000000000000000000000000000000000111
110000000000000000000000000000000000111
110000000000000000000000000000000000111
111111111111111110001111111100011000111
111111111111111110001111111100000011111
111111111111111110001111111100000000111
111111111111111110001111111111111111111
111111111111111110001111111111111111111
111111111111111110001111111111111111111
