-32
30
-10
31
11111111111111111111111111111111111111111111111111111111111111
11111111111111111111111111111111111111111111111111111111111111
11111111111111111111111111111111111111111111111111111111111111
11111111111111111111111111111111111111111111111111111111111111
11000000000000001111111111111111111111111111111111111111111110
11000000000000001111111000000000000000111111111111110000001111
11000000000000001111111000000000000000111111111111100000000111
11000000000000001111111000000000011100111111100011100000000111
11000000000000001111111000000000011100111111100011100000000111
11000000000000001111111000000000011100011111110000000000000111
11000000000000001111111000000000000000001111110000000000000111
11111011111111011111111000000000000000001100000000000000000111
11111011111111011111111000000000000000000000000000000000000111
11110001111000000000000000000000000000000000000000000000000111
11110001111000000000000000000000000000001111110000000000000111
11110001111000000000000000000000000001111111110000000000010111
11110001111100000000000000000000000001111111110000000000000111
00000001111100000000000000000000000001111111110000000000000111
00000001111100000000000000000000000011111111110000000000000111
00000001111100000000000000000000011111111111110000000000000111
11111111111110000000000000000000011111111111110000000000000111
11111111111110000001111111111000011111111111110000000000000111
11111111111111111111111111111111111111111111110000000000000111
11111111111111111111111111111111111111111110000000000000000111
11111111111111111111111111111111111111111110000000011110000011
11111111111111111111111111111111111111111110000000011110000011
11111111111111111111111111111111111111111110000000001110000011
11111111111111111111111111111100011111111110000000000000000011
11111111111111111111111111111100011111111110000000000000000011
11111111111111111111111111111000000000000000000000000000000011
11111111111111111111000000000000000000000000000000000000000011
11111111111111111111000000000000000000000000000000000000000011
11111111111111111111000000000000000000000000000000000000000011
11111111111111111111000000000000000000000000000000000000000011
11111111111111111111000001110000000000000000000000000000111111
11111111111111111111100011111111111111111111111111111111111111
11111111111111111111100011111111111111111111111111111111111111
11111111111111111111100011111111111111111111111111111111111111
11111111111111111111100011111111111111111111111111111111111111
11111111111111111111100011111111111111111111111111111111111111
11111111111111111111100011111111111111111111111111111111111111
