-22
17
-21
2
100001111111111111111111111111111100001
100001111111111111111111111111111100001
100001111111111111111111111111111100001
101111111111111111111111111111111111101
101111111111111111111111111111111111101
101111111111111111111111111111111111101
101111111111111111111111111111111111101
101111111111111111111111111111111111101
101111111111111111101111111111111111101
100000000001000000000011100000000010001
100001000000000000000000000000000000001
100000000000000000000000000000000000001
100110111001001000000000111000111100001
100110111000000000000000111000111100001
100000111001101110000000000011000000001
111000000001101110000000110011011101101
111111000100001110000000110000011101101
100111000000000000000000000000000000001
111111111111111111000111111111111111111
111111111111111111000111111111111111111
111111111111111111000111111111111111111
111111111111111111000111111111111111111
111111111111111111000111111111111111111
